111111111111111111111
1PCCCCCCCCCCCCCCCCCC1
1111111111111111111C1
1CCCCCCCCCCCCCCCCCCC1
1C1111111111111111111
1CCCCCCCCCCCCCCCCCCE1
111111111111111111111
