1111111111
11C10000P1
1101001001
11000E10C1
1111111111
