111111111111
100100E100C1
10C100000001
10000P0001C1
111000010001
111111111111
