111111111111
100100E100C1
100100000001
10000P000101
111000010001
111111111111
