111111111111
100100E101C1
100000000001
10000P000101
111000000001
111111111111
