1111111111111111
110001000100C0E1
1000010000000001
1011111111100001
1C00000000100001
10000100C0000C01
1111111111111111
