111111111111
1001000101C1
100000000001
1110E0000111
1P10000000C1
111111111111
