111111111111
10E1000101C1
100001000001
11010C100111
1P10110000C1
111111111111
