111111111111
100100E101C1
100000000001
10000P000111
1110000001C1
111111111111
