11111111111
1CCCCCCCC11
1CCCCCCCC11
1CCCCCCPC11
1CCCCCCCC11
1CECCCCCC11
11111111111
11111111111
11111111110
11111111111
11111111111
11111111111
