1111111111111111
1P0001000100C101
100001000000E001
1011111111100001
1C00000000100001
10000100C0000C01
1111111011111111
