1111111111111111
1P0001000E1000C1
1000010000000001
1011111111111101
1C00000000100001
10000100C0000C01
1111111111111111
